..........@@..##..####....
..........@@..##..####....
...#########..##..........
...#########..##..........
......#...##..####..%%%%%%
......#...##..####..%%%%%%
...#..........@@..%%%%%%%%
...#..........@@..%%%%%%%%
...#..######@@####%%%%##@@
...#..######@@####%%%%..@@
..######@@....##..%%%%...#
........@@....##..%%%%...#
.#######..@@%%%%%%%%%%....
.#######..@@%%%%%%%%%%....
......@@....%%%%%%%%%%##..
......@@....%%%%%%%%%%##..
@@##..%%%%%%%%@@%%%%%%##..
@@##..%%%%%%%%@@%%%%%%##..
.###%%%%%%%%%%........###.
.###%%%%%%%%%%........###.
..##%%%%........@@######..
..##%%%%..........######..
....%%%%..........##...#..
....%%%%...####...##...#..
....%%%%...#..#...........
..##%%%%...#..#...........